
* * * * * * * * * * * * * * * 
*                       *   * 
*   *   * * * * * * *   *   * 
*   *   *           *       * 
*   *   *   * * *   * * *   * 
*   *   *   *           *   * 
* * *   *   * * * * * * *   * 
*       *                   * 
*   * * *   * * * * * * * * * 
*   *   *   *               * 
*   *   *   * * *   * * *   * 
*   *   *       *   *       * 
*   *   * * *   * * *   *   * 
* S *                   *   * 
* * * * * * * * * * * * * * * 